i - переход в режим вставки
ESC - возврат в командный режим.

1G или H - перейти к первой строке.
G или L - перейти к последней строке в файле.
M - перейти к средней строке в файле.

w - переместить курсор к началу следующего слова.
W - переместить курсор на следующее слово игнорируя знаки препинания.
b - переместить курсор к началу предыдущего слова.
B - переместить курсор к началу предыдущего слова игнорируя знаки препинания.

u - отменить предыдущую команду.
. - повторить последнюю команду.

:e - отменить изменения.
:w - записать изменения.
:q - выйти из файла.
:q! или ZQ - выйти не сохраняя.
:wq! или ZZ - выйти и сохранить.

yy - скопировать строку.
yw - скопировать слово.
yl - скопировать символ.
nyy - скопировать n строк.

dd - вырезать строку.
dw - вырезать слово.
dl - вырезать символ.

D - вырезать часть строки справа от курсора.
S - вырезать строку и добавить текст.
С - вырезать часть строки справа от курсора и добавить текст.
s - вырезать символ под курсором и добавить текст.

p - вставить.

/ - начать поиск ниже.
? - начать поиск выше.
N и n - продолжить поиск.



